R 100 720
NO ./map/textures/1024/wall.xpm

SO ./map/textures/1024/wall.xpm

WE ./map/textures/1024/wall2.xpm

EA ./map/textures/1024/wall2.xpm

S ./map/textures/1024/spr.xpm

F  255,  40,0

C    150,  40,0
        1111111111111111111111111
        1000000000110000000000001
        1011000001110000002000001
        1001000000000000000000001
111111111011000001112222222222221
100000000011000001110111111111111
11110111111111011100000000001
11110111111111011101010010001
11000000110101011100002010201
10002000000000001100000010201
10000020000002001101010010001
11000001110101011111011110N0111
11110111 1110101 101111010001
11111111 1111111 111111111111

