R 500 500
NO ./map/textures/walls/stone1.xpm

SO ./map/textures/walls/wall1.xpm

WE ./map/textures/walls/wall2.xpm

EA ./map/textures/walls/wall3.xpm

S ./map/textures/sprites/ammo.xpm

F  0, 0, 0

C    255,  255,255

 111111111111
10200000000021
10001 1111111
 10011
11 1
11 11
10001
10001
10001
10001
100001
1000001
10000001
100000001
10000001
1000001
100001
100S1
1111
