R 1000 1000
NO ./map/textures/walls/stone1.xpm

SO ./map/textures/walls/wall1.xpm

WE ./map/textures/walls/wall2.xpm

EA ./map/textures/walls/wall3.xpm

S ./map/textures/sprites/ammo.xpm

F  0, 0, 0

C    255,  255,255
11111111111111111111
12001111111110000001
10000000000000000001
10011110000000000001
10000000000000000001
10000000000000020001
10000001111111111111111
10000000000000000001
10110000000000000001
10110000000000000001
10000000001100000001
11122111111100022001
12000001111000022001111111111
10000000221000000001222222221
11110001221000000000       21
120000011111000000012      21
100000000000111000N1222222221
11111111111111111111111111111
